
=============================================================================================================================================================================

                                                                             Core map (t=0)

=============================================================================================================================================================================
 Block average:
  Blk ID          Volume Fission neutron           Power      Absorption     Scalar flux
     101        3.227599    5.855689e-03    7.795560e-14    3.513468e-03    1.122311e-01
     102        3.227599    1.133551e-02    1.509845e-13    6.764248e-03    1.898746e-01
     103        3.227599    1.587546e-02    2.114785e-13    9.463875e-03    2.571340e-01
     104        3.227599    1.985075e-02    2.644442e-13    1.182817e-02    3.175644e-01
     105        3.227599    2.328535e-02    3.102034e-13    1.387192e-02    3.707902e-01
     106        3.227599    2.618773e-02    3.488706e-13    1.559978e-02    4.162860e-01
     107        3.227599    2.854485e-02    3.802731e-13    1.700349e-02    4.534694e-01
     108        3.227599    3.033628e-02    4.041390e-13    1.807051e-02    4.818263e-01
     109        3.227599    3.154253e-02    4.202089e-13    1.878906e-02    5.009557e-01
     110        3.227599    3.214934e-02    4.282929e-13    1.915055e-02    5.105878e-01
     111        3.227599    3.214934e-02    4.282929e-13    1.915055e-02    5.105878e-01
     112        3.227599    3.154253e-02    4.202089e-13    1.878906e-02    5.009557e-01
     113        3.227599    3.033628e-02    4.041390e-13    1.807051e-02    4.818263e-01
     114        3.227599    2.854485e-02    3.802731e-13    1.700349e-02    4.534694e-01
     115        3.227599    2.618773e-02    3.488706e-13    1.559978e-02    4.162860e-01
     116        3.227599    2.328535e-02    3.102034e-13    1.387192e-02    3.707902e-01
     117        3.227599    1.985075e-02    2.644442e-13    1.182817e-02    3.175644e-01
     118        3.227599    1.587546e-02    2.114785e-13    9.463875e-03    2.571340e-01
     119        3.227599    1.133551e-02    1.509845e-13    6.764248e-03    1.898746e-01
     120        3.227599    5.855689e-03    7.795560e-14    3.513468e-03    1.122311e-01

 Block max:
  Blk ID Fission neutron           Power      Absorption     Scalar flux
     101    5.859084e-03    7.800088e-14    3.515396e-03    1.122550e-01
     102    1.134187e-02    1.510692e-13    6.767833e-03    1.899137e-01
     103    1.588365e-02    2.115877e-13    9.468485e-03    2.571808e-01
     104    1.985981e-02    2.645649e-13    1.183324e-02    3.176114e-01
     105    2.329439e-02    3.103239e-13    1.387696e-02    3.708307e-01
     106    2.619607e-02    3.489819e-13    1.560441e-02    4.163149e-01
     107    2.855211e-02    3.803699e-13    1.700747e-02    4.534843e-01
     108    3.034237e-02    4.042202e-13    1.807381e-02    4.818305e-01
     109    3.154765e-02    4.202772e-13    1.879180e-02    5.009609e-01
     110    3.215392e-02    4.283540e-13    1.915297e-02    5.105966e-01
     111    3.215392e-02    4.283540e-13    1.915297e-02    5.105966e-01
     112    3.154765e-02    4.202772e-13    1.879180e-02    5.009609e-01
     113    3.034237e-02    4.042202e-13    1.807381e-02    4.818305e-01
     114    2.855211e-02    3.803699e-13    1.700747e-02    4.534843e-01
     115    2.619607e-02    3.489819e-13    1.560441e-02    4.163149e-01
     116    2.329439e-02    3.103239e-13    1.387696e-02    3.708307e-01
     117    1.985981e-02    2.645649e-13    1.183324e-02    3.176114e-01
     118    1.588365e-02    2.115877e-13    9.468485e-03    2.571808e-01
     119    1.134187e-02    1.510692e-13    6.767833e-03    1.899137e-01
     120    5.859084e-03    7.800088e-14    3.515396e-03    1.122550e-01

