
=============================================================================================================================================================================

                                                                             Core map (t=0)

=============================================================================================================================================================================
 Block average:
  Blk ID          Volume Fission neutron           Power      Absorption     Scalar flux
     101        3.227599    5.852388e-03    7.791094e-14    3.510675e-03    1.121633e-01
     102        3.227599    1.133297e-02    1.509500e-13    6.761510e-03    1.897365e-01
     103        3.227599    1.587282e-02    2.114435e-13    9.461320e-03    2.569431e-01
     104        3.227599    1.984630e-02    2.643853e-13    1.182470e-02    3.173254e-01
     105        3.227599    2.326245e-02    3.098982e-13    1.385908e-02    3.705047e-01
     106        3.227599    2.616819e-02    3.486104e-13    1.558909e-02    4.160163e-01
     107        3.227599    2.854813e-02    3.803171e-13    1.700697e-02    4.532887e-01
     108        3.227599    3.035018e-02    4.043244e-13    1.807988e-02    4.817494e-01
     109        3.227599    3.159110e-02    4.208568e-13    1.881635e-02    5.009879e-01
     110        3.227599    3.220843e-02    4.290810e-13    1.918358e-02    5.107147e-01
     111        3.227599    3.219400e-02    4.288892e-13    1.917595e-02    5.107980e-01
     112        3.227599    3.158462e-02    4.207711e-13    1.881353e-02    5.011795e-01
     113        3.227599    3.036942e-02    4.045812e-13    1.808670e-02    4.819857e-01
     114        3.227599    2.856825e-02    3.805856e-13    1.701456e-02    4.535606e-01
     115        3.227599    2.619338e-02    3.489471e-13    1.560462e-02    4.163028e-01
     116        3.227599    2.328674e-02    3.102229e-13    1.387380e-02    3.707413e-01
     117        3.227599    1.985468e-02    2.644972e-13    1.183227e-02    3.174707e-01
     118        3.227599    1.587017e-02    2.114084e-13    9.462176e-03    2.570225e-01
     119        3.227599    1.132410e-02    1.508324e-13    6.757085e-03    1.897956e-01
     120        3.227599    5.847317e-03    7.784383e-14    3.508363e-03    1.122115e-01

 Block max:
  Blk ID Fission neutron           Power      Absorption     Scalar flux
     101    5.855794e-03    7.795637e-14    3.512609e-03    1.121873e-01
     102    1.133934e-02    1.510349e-13    6.765103e-03    1.897758e-01
     103    1.588102e-02    2.115529e-13    9.465934e-03    2.569900e-01
     104    1.985534e-02    2.645058e-13    1.182977e-02    3.173724e-01
     105    2.327142e-02    3.100179e-13    1.386409e-02    3.705449e-01
     106    2.617643e-02    3.487203e-13    1.559365e-02    4.160446e-01
     107    2.855526e-02    3.804121e-13    1.701088e-02    4.533027e-01
     108    3.035611e-02    4.044035e-13    1.808309e-02    4.817529e-01
     109    3.159606e-02    4.209230e-13    1.881899e-02    5.009939e-01
     110    3.221285e-02    4.291400e-13    1.918591e-02    5.107243e-01
     111    3.219844e-02    4.289484e-13    1.917829e-02    5.108075e-01
     112    3.158963e-02    4.208379e-13    1.881620e-02    5.011853e-01
     113    3.037542e-02    4.046613e-13    1.808995e-02    4.819896e-01
     114    2.857546e-02    3.806817e-13    1.701852e-02    4.535753e-01
     115    2.620171e-02    3.490582e-13    1.560924e-02    4.163319e-01
     116    2.329580e-02    3.103437e-13    1.387886e-02    3.707822e-01
     117    1.986379e-02    2.646187e-13    1.183738e-02    3.175184e-01
     118    1.587843e-02    2.115185e-13    9.466825e-03    2.570701e-01
     119    1.133051e-02    1.509179e-13    6.760706e-03    1.898354e-01
     120    5.850748e-03    7.788958e-14    3.510311e-03    1.122358e-01

