
=============================================================================================================================================================================

                                                                             Core map (t=0)

=============================================================================================================================================================================
 Block average:
  Blk ID          Volume Fission neutron           Power      Absorption     Scalar flux
     101        3.227599    5.850842e-03    7.789086e-14    3.510441e-03    1.122361e-01
     102        3.227599    1.132664e-02    1.508661e-13    6.758641e-03    1.898553e-01
     103        3.227599    1.586417e-02    2.113281e-13    9.456629e-03    2.570978e-01
     104        3.227599    1.983994e-02    2.643001e-13    1.182096e-02    3.175276e-01
     105        3.227599    2.328183e-02    3.101566e-13    1.386881e-02    3.707846e-01
     106        3.227599    2.619839e-02    3.490134e-13    1.560702e-02    4.163517e-01
     107        3.227599    2.856491e-02    3.805412e-13    1.701630e-02    4.535855e-01
     108        3.227599    3.035989e-02    4.044546e-13    1.808542e-02    4.819628e-01
     109        3.227599    3.156712e-02    4.205376e-13    1.880450e-02    5.010913e-01
     110        3.227599    3.217243e-02    4.286017e-13    1.916512e-02    5.107049e-01
     111        3.227599    3.217178e-02    4.285931e-13    1.916292e-02    5.106710e-01
     112        3.227599    3.156199e-02    4.204695e-13    1.879969e-02    5.010041e-01
     113        3.227599    3.035320e-02    4.043656e-13    1.807963e-02    4.818401e-01
     114        3.227599    2.855774e-02    3.804460e-13    1.701037e-02    4.534489e-01
     115        3.227599    2.619290e-02    3.489406e-13    1.560243e-02    4.162296e-01
     116        3.227599    2.329167e-02    3.102881e-13    1.387628e-02    3.706985e-01
     117        3.227599    1.984995e-02    2.644340e-13    1.182852e-02    3.174569e-01
     118        3.227599    1.587337e-02    2.114511e-13    9.463407e-03    2.570311e-01
     119        3.227599    1.133382e-02    1.509623e-13    6.763802e-03    1.897900e-01
     120        3.227599    5.854400e-03    7.793869e-14    3.512998e-03    1.121764e-01

 Block max:
  Blk ID Fission neutron           Power      Absorption     Scalar flux
     101    5.854321e-03    7.793726e-14    3.512417e-03    1.122608e-01
     102    1.133315e-02    1.509529e-13    6.762316e-03    1.898960e-01
     103    1.587256e-02    2.114400e-13    9.461353e-03    2.571466e-01
     104    1.984921e-02    2.644238e-13    1.182617e-02    3.175767e-01
     105    2.329108e-02    3.102799e-13    1.387398e-02    3.708271e-01
     106    2.620693e-02    3.491272e-13    1.561175e-02    4.163824e-01
     107    2.857231e-02    3.806400e-13    1.702037e-02    4.536017e-01
     108    3.036608e-02    4.045371e-13    1.808878e-02    4.819676e-01
     109    3.157228e-02    4.206065e-13    1.880726e-02    5.010964e-01
     110    3.217699e-02    4.286626e-13    1.916753e-02    5.107139e-01
     111    3.217629e-02    4.286533e-13    1.916530e-02    5.106803e-01
     112    3.156701e-02    4.205364e-13    1.880237e-02    5.010100e-01
     113    3.035915e-02    4.044450e-13    1.808285e-02    4.818434e-01
     114    2.856485e-02    3.805408e-13    1.701427e-02    4.534622e-01
     115    2.620109e-02    3.490498e-13    1.560696e-02    4.162569e-01
     116    2.330057e-02    3.104067e-13    1.388124e-02    3.707374e-01
     117    1.985888e-02    2.645531e-13    1.183353e-02    3.175025e-01
     118    1.588146e-02    2.115590e-13    9.467958e-03    2.570767e-01
     119    1.134010e-02    1.510461e-13    6.767345e-03    1.898283e-01
     120    5.857758e-03    7.798346e-14    3.514904e-03    1.121997e-01

