
=============================================================================================================================================================================

                                                                             Core map (t=0)

=============================================================================================================================================================================
 Block average:
  Blk ID          Volume Fission neutron           Power      Absorption     Scalar flux
     101        3.227599    5.841090e-03    7.776036e-14    3.503157e-03    1.121692e-01
     102        3.227599    1.132708e-02    1.508715e-13    6.760425e-03    1.897718e-01
     103        3.227599    1.585662e-02    2.112273e-13    9.453945e-03    2.571087e-01
     104        3.227599    1.982606e-02    2.641152e-13    1.181539e-02    3.175992e-01
     105        3.227599    2.329646e-02    3.103516e-13    1.387766e-02    3.709021e-01
     106        3.227599    2.622692e-02    3.493932e-13    1.561728e-02    4.164780e-01
     107        3.227599    2.858393e-02    3.807955e-13    1.702731e-02    4.536595e-01
     108        3.227599    3.036394e-02    4.045087e-13    1.808934e-02    4.820012e-01
     109        3.227599    3.155124e-02    4.203265e-13    1.879714e-02    5.011002e-01
     110        3.227599    3.215591e-02    4.283819e-13    1.915697e-02    5.106989e-01
     111        3.227599    3.217373e-02    4.286186e-13    1.916274e-02    5.106410e-01
     112        3.227599    3.154765e-02    4.202780e-13    1.879115e-02    5.009222e-01
     113        3.227599    3.034093e-02    4.042031e-13    1.807629e-02    4.817334e-01
     114        3.227599    2.853638e-02    3.801604e-13    1.700286e-02    4.533100e-01
     115        3.227599    2.619599e-02    3.489816e-13    1.559944e-02    4.161228e-01
     116        3.227599    2.326346e-02    3.099120e-13    1.385917e-02    3.705622e-01
     117        3.227599    1.983304e-02    2.642083e-13    1.181855e-02    3.173313e-01
     118        3.227599    1.584698e-02    2.110988e-13    9.448137e-03    2.569651e-01
     119        3.227599    1.133818e-02    1.510204e-13    6.763593e-03    1.897277e-01
     120        3.227599    5.839989e-03    7.774525e-14    3.501531e-03    1.121490e-01

 Block max:
  Blk ID Fission neutron           Power      Absorption     Scalar flux
     101    5.844508e-03    7.780594e-14    3.505097e-03    1.121933e-01
     102    1.133347e-02    1.509568e-13    6.764034e-03    1.898113e-01
     103    1.586483e-02    2.113368e-13    9.458568e-03    2.571559e-01
     104    1.983512e-02    2.642360e-13    1.182047e-02    3.176465e-01
     105    2.330549e-02    3.104721e-13    1.388271e-02    3.709426e-01
     106    2.623525e-02    3.495043e-13    1.562189e-02    4.165067e-01
     107    2.859113e-02    3.808914e-13    1.703126e-02    4.536738e-01
     108    3.036993e-02    4.045886e-13    1.809258e-02    4.820049e-01
     109    3.155624e-02    4.203932e-13    1.879981e-02    5.011061e-01
     110    3.216036e-02    4.284413e-13    1.915931e-02    5.107084e-01
     111    3.217820e-02    4.286781e-13    1.916509e-02    5.106504e-01
     112    3.155266e-02    4.203449e-13    1.879382e-02    5.009280e-01
     113    3.034693e-02    4.042832e-13    1.807954e-02    4.817372e-01
     114    2.854359e-02    3.802567e-13    1.700682e-02    4.533246e-01
     115    2.620434e-02    3.490929e-13    1.560406e-02    4.161518e-01
     116    2.327251e-02    3.100327e-13    1.386423e-02    3.706030e-01
     117    1.984214e-02    2.643297e-13    1.182365e-02    3.173788e-01
     118    1.585523e-02    2.112087e-13    9.452778e-03    2.570125e-01
     119    1.134461e-02    1.511060e-13    6.767217e-03    1.897675e-01
     120    5.843417e-03    7.779097e-14    3.503477e-03    1.121732e-01

