
=============================================================================================================================================================================

                                                                             Core map (t=0)

=============================================================================================================================================================================
 Block average:
  Blk ID          Volume Fission neutron           Power      Absorption     Scalar flux
     101        3.227599    5.849504e-03    7.787229e-14    3.508256e-03    1.122643e-01
     102        3.227599    1.133833e-02    1.510221e-13    6.764424e-03    1.899484e-01
     103        3.227599    1.588746e-02    2.116387e-13    9.469704e-03    2.572723e-01
     104        3.227599    1.986452e-02    2.646275e-13    1.183874e-02    3.177408e-01
     105        3.227599    2.331386e-02    3.105833e-13    1.388780e-02    3.709551e-01
     106        3.227599    2.622638e-02    3.493866e-13    1.562224e-02    4.164534e-01
     107        3.227599    2.854595e-02    3.802878e-13    1.700528e-02    4.536699e-01
     108        3.227599    3.037538e-02    4.046609e-13    1.809300e-02    4.820473e-01
     109        3.227599    3.160654e-02    4.210632e-13    1.882242e-02    5.011853e-01
     110        3.227599    3.216671e-02    4.285246e-13    1.916348e-02    5.107372e-01
     111        3.227599    3.216951e-02    4.285628e-13    1.916345e-02    5.106581e-01
     112        3.227599    3.154796e-02    4.202821e-13    1.879359e-02    5.009455e-01
     113        3.227599    3.033709e-02    4.041513e-13    1.806731e-02    4.816981e-01
     114        3.227599    2.854750e-02    3.803082e-13    1.700364e-02    4.532858e-01
     115        3.227599    2.619274e-02    3.489380e-13    1.560380e-02    4.160540e-01
     116        3.227599    2.327071e-02    3.100087e-13    1.386086e-02    3.705323e-01
     117        3.227599    1.984981e-02    2.644319e-13    1.182638e-02    3.172505e-01
     118        3.227599    1.585210e-02    2.111682e-13    9.451065e-03    2.568002e-01
     119        3.227599    1.129845e-02    1.504905e-13    6.744136e-03    1.896008e-01
     120        3.227599    5.840268e-03    7.774932e-14    3.503731e-03    1.120887e-01

 Block max:
  Blk ID Fission neutron           Power      Absorption     Scalar flux
     101    5.852917e-03    7.791781e-14    3.510193e-03    1.122881e-01
     102    1.134473e-02    1.511074e-13    6.768030e-03    1.899877e-01
     103    1.589570e-02    2.117485e-13    9.474340e-03    2.573193e-01
     104    1.987362e-02    2.647488e-13    1.184384e-02    3.177879e-01
     105    2.332294e-02    3.107043e-13    1.389286e-02    3.709956e-01
     106    2.623475e-02    3.494982e-13    1.562687e-02    4.164823e-01
     107    2.855320e-02    3.803845e-13    1.700926e-02    4.536847e-01
     108    3.038147e-02    4.047422e-13    1.809631e-02    4.820511e-01
     109    3.161167e-02    4.211317e-13    1.882517e-02    5.011908e-01
     110    3.217129e-02    4.285858e-13    1.916590e-02    5.107461e-01
     111    3.217410e-02    4.286241e-13    1.916588e-02    5.106669e-01
     112    3.155311e-02    4.203509e-13    1.879634e-02    5.009509e-01
     113    3.034323e-02    4.042331e-13    1.807063e-02    4.817022e-01
     114    2.855481e-02    3.804057e-13    1.700765e-02    4.533012e-01
     115    2.620115e-02    3.490502e-13    1.560846e-02    4.160835e-01
     116    2.327982e-02    3.101303e-13    1.386595e-02    3.705734e-01
     117    1.985896e-02    2.645540e-13    1.183151e-02    3.172982e-01
     118    1.586038e-02    2.112785e-13    9.455721e-03    2.568475e-01
     119    1.130486e-02    1.505759e-13    6.747750e-03    1.896403e-01
     120    5.843698e-03    7.779506e-14    3.505678e-03    1.121128e-01

